NO ./textures/NORTH.xpm

SO		./textures/SOUTH.xpm

WE ./textures/WEST.xpm

EA ./textures/EAST.xpm

F 102,0,0
C 102,178,255

11111
10001
10N01
10001
11111