NO ./textures/wall_north_south.xpm

SO		./textures/wall_north_south.xpm

WE ./textures/wall_west.xpm

EA ./textures/wall_east.xpm

F 102,0,0
C 102,178,255

         111111111111111111111111
        1000000000110000000000001
        101100000111000000000000N
        1001000000000000000000001
111111111011000001110000000000001
10000000001100000111011111011111
11110111111111011100000010001
11110111101111011101010010001
11000000110101011100000010001
10000000000000001100000010001
10000000000000001101010010001
110000011101010111110111100111
11110111 1110101 101111010001
11111111 1111111  1111111111