NO ./textures/ground.xpm

SO		 ./textures/ground.xpm

WE ./textures/ground.xpm

EA ./textures/ground.xpm

F 255,100,255
C 225,30,0a

         111111111111111111111111
        1000000000110000000000001
        1011000001110000000000001
        1001000000000000000000001
111111111011000001110000000000001
10000000001100000111011111111111
11110111111111011100000010001
11110111101111011101010010001
11000000110101011100000010001
10000000000000001100000010001
10000000000000001101010010001
11000001110101011111011110N0111
11110111 1110101 101111010001
11111111 1111111  1111111111