NO ./textures/wall_north_south.xpm

SO		./textures/wall_north_south.xpm

WE ./textures/wall_west.xpm

EA ./textures/wall_east.xpm

F 102,0,0
C 102,178,255

11111
10001
10A01
10001
11111